

####################
#.................s#
#.......r..........#
#.....###..........#
#......@...........#
#..................#
####################